"filename", "language", "CMake", "C++", "comment", "blank", "total"
"f:\MVulkanEngine\src\CMakeLists.txt", "CMake", 41, 0, 0, 15, 56
"f:\MVulkanEngine\src\include\Camera.hpp", "C++", 0, 74, 1, 26, 101
"f:\MVulkanEngine\src\include\MVulkanRHI\MVulkanAttachmentBuffer.hpp", "C++", 0, 18, 14, 10, 42
"f:\MVulkanEngine\src\include\MVulkanRHI\MVulkanBuffer.hpp", "C++", 0, 157, 40, 39, 236
"f:\MVulkanEngine\src\include\MVulkanRHI\MVulkanCommand.hpp", "C++", 0, 96, 2, 25, 123
"f:\MVulkanEngine\src\include\MVulkanRHI\MVulkanDescriptor.hpp", "C++", 0, 52, 5, 13, 70
"f:\MVulkanEngine\src\include\MVulkanRHI\MVulkanDevice.hpp", "C++", 0, 64, 1, 27, 92
"f:\MVulkanEngine\src\include\MVulkanRHI\MVulkanEngine.hpp", "C++", 0, 158, 8, 42, 208
"f:\MVulkanEngine\src\include\MVulkanRHI\MVulkanFrameBuffer.hpp", "C++", 0, 53, 3, 18, 74
"f:\MVulkanEngine\src\include\MVulkanRHI\MVulkanInstance.hpp", "C++", 0, 22, 0, 12, 34
"f:\MVulkanEngine\src\include\MVulkanRHI\MVulkanPipeline.hpp", "C++", 0, 26, 0, 10, 36
"f:\MVulkanEngine\src\include\MVulkanRHI\MVulkanRenderPass.hpp", "C++", 0, 23, 0, 9, 32
"f:\MVulkanEngine\src\include\MVulkanRHI\MVulkanSampler.hpp", "C++", 0, 10, 0, 4, 14
"f:\MVulkanEngine\src\include\MVulkanRHI\MVulkanShader.hpp", "C++", 0, 55, 3, 18, 76
"f:\MVulkanEngine\src\include\MVulkanRHI\MVulkanSwapchain.hpp", "C++", 0, 49, 0, 19, 68
"f:\MVulkanEngine\src\include\MVulkanRHI\MVulkanSyncObject.hpp", "C++", 0, 23, 0, 8, 31
"f:\MVulkanEngine\src\include\MVulkanRHI\MWindow.hpp", "C++", 0, 29, 0, 8, 37
"f:\MVulkanEngine\src\include\Managers\GlobalConfig.hpp", "C++", 0, 11, 0, 7, 18
"f:\MVulkanEngine\src\include\Managers\InputManager.hpp", "C++", 0, 33, 1, 7, 41
"f:\MVulkanEngine\src\include\Managers\Singleton.hpp", "C++", 0, 22, 2, 4, 28
"f:\MVulkanEngine\src\include\Managers\TextureManager.hpp", "C++", 0, 25, 0, 11, 36
"f:\MVulkanEngine\src\include\RenderPass.hpp", "C++", 0, 64, 5, 20, 89
"f:\MVulkanEngine\src\include\Scene\Light\DirectionalLight.hpp", "C++", 0, 14, 0, 5, 19
"f:\MVulkanEngine\src\include\Scene\Light\Light.hpp", "C++", 0, 27, 0, 7, 34
"f:\MVulkanEngine\src\include\Scene\Light\PointLight.hpp", "C++", 0, 14, 0, 7, 21
"f:\MVulkanEngine\src\include\Scene\Material.hpp", "C++", 0, 10, 0, 7, 17
"f:\MVulkanEngine\src\include\Scene\Model.hpp", "C++", 0, 10, 39, 5, 54
"f:\MVulkanEngine\src\include\Scene\Scene.hpp", "C++", 0, 73, 2, 21, 96
"f:\MVulkanEngine\src\include\Scene\SceneLoader.hpp", "C++", 0, 25, 0, 14, 39
"f:\MVulkanEngine\src\include\Shaders\Shader.hpp", "C++", 0, 22, 3, 7, 32
"f:\MVulkanEngine\src\include\Shaders\ShaderModule.hpp", "C++", 0, 130, 0, 37, 167
"f:\MVulkanEngine\src\include\Shaders\ShaderResourceMap.hpp", "C++", 0, 8, 0, 7, 15
"f:\MVulkanEngine\src\include\Util.cpp", "C++", 0, 0, 0, 1, 1
"f:\MVulkanEngine\src\include\Util.hpp", "C++", 0, 13, 0, 4, 17
"f:\MVulkanEngine\src\include\Utils\MImage.hpp", "C++", 0, 44, 16, 15, 75
"f:\MVulkanEngine\src\include\Utils\VulkanUtil.hpp", "C++", 0, 168, 15, 38, 221
"f:\MVulkanEngine\src\source\Camera.cpp", "C++", 0, 41, 4, 11, 56
"f:\MVulkanEngine\src\source\MVulkanRHI\MVulkanAttachmentBuffer.cpp", "C++", 0, 43, 27, 10, 80
"f:\MVulkanEngine\src\source\MVulkanRHI\MVulkanBuffer.cpp", "C++", 0, 153, 73, 51, 277
"f:\MVulkanEngine\src\source\MVulkanRHI\MVulkanCommandList.cpp", "C++", 0, 199, 18, 44, 261
"f:\MVulkanEngine\src\source\MVulkanRHI\MVulkanCommandPool.cpp", "C++", 0, 28, 0, 8, 36
"f:\MVulkanEngine\src\source\MVulkanRHI\MVulkanCommandQueue.cpp", "C++", 0, 20, 0, 7, 27
"f:\MVulkanEngine\src\source\MVulkanRHI\MVulkanDescriptor.cpp", "C++", 0, 95, 42, 27, 164
"f:\MVulkanEngine\src\source\MVulkanRHI\MVulkanDevice.cpp", "C++", 0, 242, 9, 74, 325
"f:\MVulkanEngine\src\source\MVulkanRHI\MVulkanEngine.cpp", "C++", 0, 841, 25, 249, 1115
"f:\MVulkanEngine\src\source\MVulkanRHI\MVulkanFrameBuffer.cpp", "C++", 0, 52, 0, 10, 62
"f:\MVulkanEngine\src\source\MVulkanRHI\MVulkanInstance.cpp", "C++", 0, 106, 0, 30, 136
"f:\MVulkanEngine\src\source\MVulkanRHI\MVulkanPipeline.cpp", "C++", 0, 119, 7, 21, 147
"f:\MVulkanEngine\src\source\MVulkanRHI\MVulkanRenderPass.cpp", "C++", 0, 173, 0, 33, 206
"f:\MVulkanEngine\src\source\MVulkanRHI\MVulkanSampler.cpp", "C++", 0, 27, 1, 8, 36
"f:\MVulkanEngine\src\source\MVulkanRHI\MVulkanShader.cpp", "C++", 0, 241, 27, 64, 332
"f:\MVulkanEngine\src\source\MVulkanRHI\MVulkanSwapchain.cpp", "C++", 0, 145, 1, 36, 182
"f:\MVulkanEngine\src\source\MVulkanRHI\MVulkanSyncObject.cpp", "C++", 0, 31, 0, 9, 40
"f:\MVulkanEngine\src\source\MVulkanRHI\MWindow.cpp", "C++", 0, 73, 5, 19, 97
"f:\MVulkanEngine\src\source\Managers\InputManager.cpp", "C++", 0, 56, 1, 12, 69
"f:\MVulkanEngine\src\source\Managers\TextureManager.cpp", "C++", 0, 14, 0, 6, 20
"f:\MVulkanEngine\src\source\RenderPass.cpp", "C++", 0, 217, 81, 59, 357
"f:\MVulkanEngine\src\source\Scene\Light\DirectionalLight.cpp", "C++", 0, 0, 0, 1, 1
"f:\MVulkanEngine\src\source\Scene\Light\Light.cpp", "C++", 0, 1, 0, 1, 2
"f:\MVulkanEngine\src\source\Scene\Light\PointLight.cpp", "C++", 0, 0, 0, 1, 1
"f:\MVulkanEngine\src\source\Scene\Material.cpp", "C++", 0, 0, 0, 1, 1
"f:\MVulkanEngine\src\source\Scene\Model.cpp", "C++", 0, 2, 78, 2, 82
"f:\MVulkanEngine\src\source\Scene\Scene.cpp", "C++", 0, 45, 41, 17, 103
"f:\MVulkanEngine\src\source\Scene\SceneLoader.cpp", "C++", 0, 131, 8, 46, 185
"f:\MVulkanEngine\src\source\Shaders\Shader.cpp", "C++", 0, 41, 37, 14, 92
"f:\MVulkanEngine\src\source\Shaders\ShaderModule.cpp", "C++", 0, 172, 11, 29, 212
"f:\MVulkanEngine\src\source\Shaders\ShaderResourceMap.cpp", "C++", 0, 0, 0, 1, 1
"f:\MVulkanEngine\src\source\Util.cpp", "C++", 0, 12, 0, 3, 15
"f:\MVulkanEngine\src\source\Utils\MImage.cpp", "C++", 0, 1, 0, 1, 2
"f:\MVulkanEngine\src\source\main.cpp", "C++", 0, 11, 0, 4, 15
"Total", "-", 41, 4954, 656, 1436, 7087